R 640 480
NO  ./assets/north.xpm
SO       ./assets/south.xpm
WE ./assets/west.xpm
EA ./assets/floor.xpm

S  ./assets/sprite3.xpm
F 32 , 16 , 0
C    120 , 120 , 255

11111111111111111111111111111111111111111111
12222222222222222222222222222222222222222221
12222222222222222222222222222222222222222221
12222222222222222222222222222222222222222221
12222222222222222222222222222222222222222221
12222222222222222222222222222222222222222221
12222222222222222222222222222222222222222221
12222222222222222222222222222222222222222221
12222222222222222222222222222222222222222221
122222222222222222222N2222222222222222222221
12222222222222222222222222222222222222222221
12222222222222222222222222222222222222222221
12222222222222222222222222222222222222222221
12222222222222222222222222222222222222222221
12222222222222222222222222222222222222222221
12222222222222222222222222222222222222222221
12222222222222222222222222222222222222222221
11111111111111111111111111111111111111111111
