R 1280 960
NO  ./assets/north.xpm
SO       ./assets/south.xpm
WE ./assets/west.xpm
EA ./assets/floor.xpm
S  ./assets/sprite3.xpm
F 32 , 16 , 0
C   120 ,  120 , 255

 1111111111111111111111111111
 1100000021000000000002000021
1101000020200101000020001111
120000000000S0001010101111
11000011010002000000001               111
11111011001111111111111
    1011101 1 1                         1
11111111111111
1            1
1            1
11111111111111
11111
12221
11111
