S  ./assets/sprite3.xpm
F 32 , 16 , 0
C    120 , 120 , 255
R  640 480
NO  ./assets/north.xpm
SO       ./assets/south.xpm
WE ./assets/west.xpm
EA ./assets/floor.xpm

1111111 1111111
1000001 1000021
1001001 100N001
1001001 1001001
1000001 1001001
1000201 1000001
1000201 1000001
1111111 1111111
