S  ./assets/sprite.xpm
F 32 , 16 , 0
C    120 , 120 , 255
R  1280 960
NO  ./assets/north.xpm
SO       ./assets/south.xpm
WE ./assets/west.xpm
EA ./assets/1.xpm

1111111 1111111
1000001 1000021
1001001 100S001
1001001 1001001
1000001 1001001
1000201 1000001
1000201 1000001
1111111 1111111
